2008-10-14
2008-10-17
2008-10-22
2008-10-24
2008-10-29
2008-11-01
2008-11-05
2008-11-07
2008-11-08
2008-11-12
2008-11-14
2008-11-18
2008-11-19
2008-11-21
2008-11-22
2008-11-25
2008-11-27
2008-11-29
2008-12-02
2008-12-03
2008-12-05
2008-12-06
2008-12-09
2008-12-11
2008-12-13
2008-12-15
2008-12-17
2008-12-19
2008-12-21
2008-12-23
2008-12-25
2008-12-27
2008-12-29
2008-12-30
2009-01-02
2009-01-04
2009-01-06
2009-01-07
2009-01-09
2009-01-10
2009-01-12
2009-01-14
2009-01-16
2009-01-19
2009-01-21
2009-01-22
2009-01-24
2009-01-26
2009-01-28
2009-01-30
2009-01-31
2009-02-02
2009-02-04
2009-02-06
2009-02-08
2009-02-10
2009-02-11
2009-02-17
2009-02-20
2009-02-21
2009-02-25
2009-02-27
2009-02-28
2009-03-02
2009-03-04
2009-03-06
2009-03-07
2009-03-09
2009-03-11
2009-03-13
2009-03-15
2009-03-17
2009-03-18
2009-03-20
2009-03-21
2009-03-23
2009-03-25
2009-03-28
2009-03-29
2009-04-01
2009-04-02
2009-04-04
2009-04-08
2009-04-10
2009-04-13
2009-04-15
